NO ./textures/test/North.png  
SO ./textures/test/South.png
WE ./textures/test/West.png 
EA ./textures/test/East.png 		

F 55,55,0 
C 0,100,100

1111111111111111111111111111
1000000000000000000000000001
1000000000000000000000000001
1000011111111111110000000001
1000000000000000010000000001
100W000000000000010000000001
1000000000000000010000000001
1000000000000000010000000001
1000011111111111110000000001
1000000000000000000000000001
1111111111111111111111111111
