NO ./textures/North.png  
SO ./textures/South.png
WE ./textures/West.png 
EA ./textures/East.png 		

F 55,55,0 
C 0,100,100

1111111111111111111111111111
1000000000000000000000000001
1000000000000000000000000001
1000000000000000000000000001
1000000000000000000000000001
100000000000N000000000000001
1000000000000000000000000001
1000000000000000000000000001
1000000000000000000000000001
1000000000000000000000000001
1111111111111111111111111111
