NO ./textures/test/North.png  
SO ./textures/test/South.png
WE ./textures/test/West.png 
EA ./textures/test/East.png 		

F 100,0,100
C 0,10,100

1111111111111111111111111111
1100000000000000000000000011
1000000000000000000000000001
1000000000000000000000000001
1000000011111111110000000001
1000000011111111110000000001
100E000000000000000000000001
1000000000000000000000000001
1000000011111111110000000001
1000000011111111110000000001
1000000000000000000000000001
1000000000000000000000000001
1100000000000000000000000011
1111111111111111111111111111
