NO ./textures/testwall.png
SO ./textures/testwall2.png
WE ./textures/testwall3.png
EA ./textures/testwall4.png

F 0,255,0 
C 0,0,255

        1111111111111111111111111111
        1000000000110000000000001  1
        101100000111000000000000   1
        1001000000000000000000001  1
111111111011000001110000000000001  1
100000000011000001110111111111111111
111101111111110111000000000001
111101111111110110011110100101
1100000011010101100000001111001
100000000000000010001100100001
10000000000000000000110000001
11000001110101011111011110E0011
11110111 1110101 100000000001
11111111 1111111 111111111111
