SO ./textures/lava/lava_2.png
WE ./textures/lava/lava_3.png
EA ./textures/lava/lava_4.png

F 30,10,10 
C 0,100,200

        1111111111111111111111111111
        1000000000000000000000001  1
        1001000000110000000000001  1
        1001000000110000000000001  1
111111111001000000110000000000001  1
100000000001000000110001111111111111
1000000000000000000000000000001
1110011111111100110001110110001
11100111100111001100011101100011111
1110011110011100110001110000001
1000000000000000110001111110001
1000000000000000000001111110001
1000000000000000N00000000000000111111111
1111011111110101111110111101111000000001