NO ./textures/North.png  
SO ./textures/South.png
WE ./textures/West.png 
EA ./textures/East.png 		

F 0,255,0 
C 0,0,255

1111
1E01
1001
1111
