NO ./textures/North.png  
SO ./textures/South.png
WE ./textures/West.png 
EA ./textures/East.png 		

F 55,55,0 
C 0,100,100

1111
1E01
1001
1111
