111111
1W00001
100001
1001001
111 11 1