111111
1F00001
100001
100101
111  11 1